[dvorak]
0x0022	0x0051
0x0027	0x0071
0x002b	0x007d
0x002c	0x0077
0x002d	0x0027
0x002e	0x0065
0x002f	0x005b
0x003a	0x005a
0x003b	0x007a
0x003c	0x0057
0x003d	0x005d
0x003e	0x0045
0x003f	0x007b
0x0042	0x004e
0x0043	0x0049
0x0044	0x0048
0x0045	0x0044
0x0046	0x0059
0x0047	0x0055
0x0048	0x004a
0x0049	0x0047
0x004a	0x0043
0x004b	0x0056
0x004c	0x0050
0x004e	0x004c
0x004f	0x0053
0x0050	0x0052
0x0051	0x0058
0x0052	0x004f
0x0053	0x003a
0x0054	0x004b
0x0055	0x0046
0x0056	0x003e
0x0057	0x003c
0x0058	0x0042
0x0059	0x0054
0x005a	0x003f
0x005b	0x002d
0x005d	0x003d
0x005f	0x0022
0x0062	0x006e
0x0063	0x0069
0x0064	0x0068
0x0065	0x0064
0x0066	0x0079
0x0067	0x0075
0x0068	0x006a
0x0069	0x0067
0x006a	0x0063
0x006b	0x0076
0x006c	0x0070
0x006e	0x006c
0x006f	0x0073
0x0070	0x0072
0x0071	0x0078
0x0072	0x006f
0x0073	0x003b
0x0074	0x006b
0x0075	0x0066
0x0076	0x002e
0x0077	0x002c
0x0078	0x0062
0x0079	0x0074
0x007a	0x002f
0x007b	0x005f
0x007d	0x002b

[German (with deadkeys)]
0x0022	0x0040
0x0023	0x005c
0x0026	0x005e
0x0027	0x007c
0x0028	0x002a
0x0029	0x0028
0x002a	0x007d
0x002b	0x005d
0x002d	0x002f
0x002f	0x0026
0x003a	0x003e
0x003b	0x003c
0x003d	0x0029
0x003f	0x005f
0x0059	0x005a
0x005a	0x0059
0x005f	0x003f
0x0079	0x007a
0x007a	0x0079
0x00a7	0x0023
0x00b0	0x007e
0x00c4	0x0022
0x00d6	0x003a
0x00dc	0x007b
0x00df	0x002d
0x00e4	0x0027
0x00f6	0x003b
0x00fc	0x005b
0xfe50	0x002b
0xfe51	0x003d
0xfe52	0x0060
